{
	"blocks": [
		["_", "_", "_", "_", "_", "_", "_", "_", "_", "_", "_", "_", "_"],
		["_", "_", "_", "_", "_", "_", "_", "R", "_", "_", "_", "_", "_"],
		["_", "P", "_", "_", "_", "_", "_", "P", "_", "_", "_", "_", "_"],
		["_", "G", "_", "_", "_", "G", "_", "G", "_", "_", "_", "_", "_"],
		["_", "Y", "_", "Y", "_", "Y", "Y", "Y", "_", "Y", "_", "_", "_"],
		["_", "B", "_", "B", "_", "B", "B", "B", "_", "B", "B", "_", "_"],
		["_", "B", "B", "B", "_", "B", "B", "B", "B", "B", "B", "_", "_"],
		["_", "B", "B", "B", "_", "B", "B", "B", "B", "B", "B", "B", "_"],
		["_", "B", "B", "B", "B", "B", "B", "B", "B", "B", "B", "B", "_"],
		["_", "B", "B", "B", "B", "B", "B", "B", "B", "B", "B", "B", "_"],
		["_", "_", "_", "_", "_", "_", "_", "_", "_", "_", "_", "_", "_"]
	]
}