{
	"blocks": [
		["_", "_", "_", "_", "°", "_", "_", "_", "_", "_", "_", "_", "_"],
		["_", "G", "_", "B", "_", "Y", "_", "Y", "_", "B", "_", "G", "_"],
		["_", "_", "B", "_", "B", "_", "Y", "_", "B", "_", "B", "_", "_"],
		["_", "B", "_", "B", "_", "B", "_", "B", "_", "B", "_", "B", "_"],
		["_", "_", "B", "_", "B", "_", "B", "_", "B", "_", "B", "_", "_"],
		["_", "B", "_", "R", "_", "R", "_", "R", "_", "R", "_", "B", "_"],
		["_", "_", "B", "_", "B", "_", "B", "_", "B", "_", "B", "_", "_"],
		["_", "B", "_", "B", "_", "B", "_", "B", "_", "B", "_", "B", "_"],
		["_", "_", "B", "_", "B", "_", "P", "_", "B", "_", "B", "_", "_"],
		["_", "G", "_", "B", "_", "P", "_", "P", "_", "B", "_", "G", "_"],
		["_", "_", "_", "_", "°", "_", "_", "_", "_", "_", "_", "_", "_"]
	]
}