{
	"blocks": [
		["_", "_", "_", "_", "_", "_", "_", "_", "_", "_", "_", "_", "_"],
		["_", "_", "_", "_", "_", "_", "_", "_", "_", "_", "_", "_", "_"],
		["_", "B", "B", "B", "B", "B", "B", "B", "B", "B", "B", "B", "_"],
		["_", "B", "Y", "B", "B", "B", "Y", "B", "B", "B", "Y", "B", "_"],
		["_", "B", "B", "B", "Y", "B", "B", "B", "Y", "B", "B", "B", "_"],
		["_", "B", "B", "P", "B", "R", "B", "B", "B", "P", "B", "B", "_"],
		["_", "B", "P", "B", "B", "B", "B", "R", "B", "B", "P", "B", "_"],
		["_", "B", "B", "B", "G", "B", "B", "B", "G", "B", "B", "B", "_"],
		["_", "B", "G", "B", "B", "B", "G", "B", "B", "B", "G", "B", "_"],
		["_", "B", "B", "B", "B", "B", "B", "B", "B", "B", "B", "B", "_"],
		["_", "_", "_", "_", "_", "_", "_", "_", "_", "_", "_", "_", "_"]
	]
}