{
	"blocks": [
		["_", "_", "_", "_", "°", "_", "_", "_", "_", "_", "_", "_", "_"],
		["_", "Y", "Y", "Y", "Y", "Y", "Y", "Y", "Y", "Y", "Y", "Y", "_"],
		["_", "Y", "_", "_", "_", "_", "_", "_", "_", "_", "_", "Y", "_"],
		["_", "Y", "_", "G", "G", "G", "G", "G", "G", "G", "_", "Y", "_"],
		["_", "Y", "_", "G", "_", "_", "_", "_", "_", "G", "_", "Y", "_"],
		["_", "Y", "_", "G", "_", "P", "B", "R", "_", "G", "_", "Y", "_"],
		["_", "Y", "_", "G", "_", "_", "_", "_", "_", "G", "_", "Y", "_"],
		["_", "Y", "_", "G", "G", "G", "G", "G", "G", "G", "_", "Y", "_"],
		["_", "Y", "_", "_", "_", "_", "_", "_", "_", "_", "_", "Y", "_"],
		["_", "Y", "Y", "Y", "Y", "Y", "Y", "Y", "Y", "Y", "Y", "Y", "_"],
		["_", "_", "_", "_", "°", "_", "_", "_", "_", "_", "_", "_", "_"]
	]
}