{
	"blocks": [
		["_", "_", "_", "_", "_", "_", "_", "_", "_", "_", "_", "_", "_"],
		["_", "_", "_", "P", "B", "_", "_", "_", "B", "P", "_", "_", "_"],
		["_", "_", "B", "B", "B", "B", "_", "B", "B", "B", "B", "_", "_"],
		["_", "G", "B", "B", "B", "B", "R", "B", "B", "B", "B", "G", "_"],
		["_", "B", "B", "Y", "B", "B", "B", "B", "B", "Y", "B", "B", "_"],
		["_", "Y", "B", "B", "Y", "B", "B", "B", "Y", "B", "B", "Y", "_"],
		["_", "_", "B", "B", "B", "B", "B", "B", "B", "B", "B", "_", "_"],
		["_", "_", "_", "B", "B", "G", "B", "G", "B", "B", "_", "_", "_"],
		["_", "_", "_", "_", "B", "B", "B", "B", "B", "_", "_", "_", "_"],
		["_", "_", "_", "_", "_", "B", "B", "B", "_", "_", "_", "_", "_"],
		["_", "_", "_", "_", "_", "_", "R", "_", "_", "_", "_", "_", "_"]
	]
}